00000000000000000000000000000000000000000000000000000000000000000000000000000000000000000000000000000000000000000000000000000000000000000000000000000000000000000000000000000000000000000000000000000000000000000000000000000000000000000000000000000000000000000000000000000000000000000000000000000000000000000000
00000000000000000000000000000000000000000000000000000000000000000000000000000000000000000000000000000000000000000000000000000000000000000000000000000000000000000000000000000000000000000000000000000000000000000000000000000000000000000000000000000000000000000000000000000000000000000000000000000000000000000000
00000000000000000000000000000000000000000000000000000000000000000000000000000000000000000000000000000000000000000000000000000000000000000000000000000000000000000000000000000000000000000000000000000000000000000000000000000000000000000000000000000000000000000000000000000000000000000000000000000000000000000000
00000000000000000000000000000000000000000000000000000000000000000000000000000000000000000000000000000000000000000000000066666666666666666666666666666600066666666666666666000000000000000000000000000000000000000000000000000000000000000000000000000000000000000000000000000000000000000000000000000000000000000000
00000006000000000000000000000000000000000000000000000000000000000000000000000000000000000000000000000000000000000000000060000000000000000000000000000000000000000000000000000000000000000000000000000000000000000000000000000000000006300060000000000000000000000000000000000000000000000000000000000000000000000000
00000000000000000000000000000000000000000000000000000000000000000000000000000000000000000000000000000000000000000000000060000000000000000000000000000000000000000000000000000000000000000000000000000000000000000000000000000000000006300060000000000000000000000000000000000000000000000000000000000000000000000000
00000000000000000000000000000000000000000000000000000000000000000000000000000000000000000000000000000000000000000000000060000000000000000000000000000000000000000000000006000000000000000000000000000000000000000000000000000000000006300060000000000000000000000000000000000000000000000000000000000000000000000000
00000000000000000000000000000000000000000000000000000000000000000000000000000000000000000000000000000000000000000000000060000000000000000000000000033660000000000000000006000710000000000000000000000000000000000000000000000000000006300760000000000000000000000000000000000000000000000000000000000000000000000000
00000000000000000000000000000000000000000000000000000000000000000000000000000000000000000000000000000000000000000000000060000000000000000000000000033660000000000000000006000710000000000000000000000000000000000000000000000000000006300060000000000000000000000000000000000000000000000000000000000000000000000000
00000000600000000000000000000000000000000000000000000000000000000000000000000000000000000000000000000000000000000000000060000000000000000000000066633660000000000000000006000710000000000000000000000000000000000000000000000000000006300060000000000000000000000000000000000000000000000000000000000000000000000000
00000000000000000000000000000000000000000000000000000000000000000000000000000000000000000000000000000000000000000000000060000000000033000000066000633660000000000000000006000710000000000000000000000000000000000000000000000000000006300060000000000000000000000000000000000000000000000000000000000000000000000000
00000000000000000000000000000000000000000000000000000000000000000000000000000000000000000000000000000000000000000000000060000000000000600660000000633660000000000000000006000710000000000000000000000000000000000000000000000000000006300060000000000000000000000000000000000000000000000000000000000000000000000000
00000000000000000000000000000000000000000000000000000000000000000000000000000000000000000000000000000000000000000000000060000000000000000000000000633660000000000000000006000710000000000000000000000000000000000000000000000000000006300060000000000000000000000000000000000000000000000000000000000000000000000000
00000000000000000000000000000000000000000000000000000000000000000000000000000000000000000000000000000000000000000000000060000000000000000600000000633660000000000000000006000710000000000000000000000000000000000000000000000000000006300060000000000000000000000000000000000000000000000000000000000000000000000000
00000000060000000000000000000000000000000000000000000000000000000000000000000000000000000000000000000000000000000000000060000000000000300000000000703660000000000000000006000710000000000000000000000000000000000000000000000000000006700060000000000000000000000000000000000000000000000000000000000000000000000000
00000000000000000000000000000000000000000000000000000000000000000000000000000000000000000000000000000000000000000000000060000000000000600000000000703660000000000000000006000710000000000000000000000000000000000000000000000000000006300060000000000000000000000000000000000000000000000000000000000000000000000000
00000000000000000000000000000000000000000000000000000000000000000000000000000000000000000000000000000000000000000000000000000000300000000000000000633660000000000000000006000710000000000000000000000000000000000000000000000000000006300060000000000000000000000000000000000000000000000000000000000000000000000000
00000000000000000000000000000000000000000000000000000000000000000000000000000000000000000000000000000000000000000000000000000000300000003600000000633660000000000000000006000710000000000000000000000000000000000000300000000000000006300060000000000000000000000000000000000000000000000000000000000000000000000000
00000000000000000000000000000000000000000000000000000000000000000000000000000000000000000000000000000000000000000000000000330000000000000000000000633660000000000000000606000711111111111111111100000000000003000300100000030000000006300060000000000000000000000000000000000000000000000000000000000000000000000000
00000000000000000000000000000000000000000000000000000000000000000000000000000000000000000000000000000000000000000000000000000000000000000000000000633660000000000000000006000777777777777777777700000000003301330100000330010300000006300060000000000000000000000000000000000000000000000000000000000000000000000000
04000000000000000000000000000000000000000000000000000000000000000000000000000000000000000000000000000000000000000000000000000000000006600000000000633660000000000000000006000000000000000000000000000003001100110000000110000100000006300060000000000000000000000000000000000000000000000000000000000000000000000000
00000000000000000000000000000000000000000000000000000000000000000000000000000000000000000000000000000000000000000000000000000000066000000000000000633660000000000000006006000000000000000000000000000301000000000000000000000000000000000060000000000000000000000000000000000000000000000000000000000000000000000000
00000000000010000100001000010000100001000000000000007000070000000000000000000000000000000000000000000000000000000000000000000066000000000000000000630760000000000000000006000000000000000000000000030100000000000000000000000000000000000060000000000000000000000000000000000000000000000000000000000000000000000000
00000001000010000100001000010000100001000070000700001000010000100001000010000700007000070000700007000000000000000000000000110000000000000000000000630760000000000000000006000000700700700700700700717777777777777777777777777000000000000060000000000000000000000000000000000000000000000000000000000000000000000000
11111111111111111111111111111111111111111111111111111111111111111111111111111111111111111111111111111111111111111111111111111777777777777777777777777111111111111111111111111111111111111111111111111111111111111111111111111111111111111111111111111111111111111111111111111111111111111111111111111111111111111111
11111111111111111111111111111111111111111111111111111111111111111111111111111111111111111111111111111111111111111111111111111111111111111111111111111111111111111111111111111111111111111111111111111111111111111111111111111111111111111111111111111111111111111111111111111111111111111111111111111111111111111111
