00000000000000000000000000000000000000000000000000000000000000000000000000000000000000000000000000000000000000000000000000000000000000000000000000000000000000000000000000000000000000060000000000000000000000000000000000000000000000000000000000000000000000000000000000000000000000000000000000000000000000000000
00000000000000000000000000000000000000000000000000000000000000000000000000000000000000000000000000000000000000000000000000000000000000000000000000000000000000000000000000000000000000060000000000000000000000000000000000000000000000000000000000000000000000000000000000000000000000000000000000000000000000000000
00000000000000000000000000000000000000000000000000000000000000000000000000000000000000000000000000000000000000000000000000000000000000000000000000000000000000000000000000000000000000060000000000000000000000000000000000000000000000000000000000000000000000000000000000000000000000000000000000000000000000000000
00000000000000000000000000000000000000000000000000000000000000000000000000000000000000000000000000000000000000000000000000000000000000000000000000000000000000000000000000000000000000060000000000000000000000000000000000000000000000000000000000000000000000000000000000000000000000000000000000000000000000000000
00000006000000000000000000000000000000000000000000000000000000000000000000000000000000000000000000000000000000000000000000000000000000000000000000000000000000000000000000000000000000060000000000000000000000000000000000000000000000000000000000000000000000000000000000000000000000000000000000000000000000000000
00000000000000000000000000000000000000000000000000000000000000000000000000000000000000000000000000000000000000000000000000000000000000000000000000000000000000000000000000000000000000060000000000000000000000000000000000000000000000000000000000000000000000000000000000000000000000000000000000000000000000000000
00000000000000000000000000000000000000000000000000000000000000000000000000000000000000000000000000000000000000000000000000000000000000000000000000000000000000000000000000000000000000060000000000000000000000000000000000000000000000000000000000000000000000000000000000000000000000000000000000000000000000000000
00000000000000000000000000000000000000000000000000000000000000000000000000000000000000000000000000000000000000000710000000000000000000000000000000000000000000000000000000000000000000060000000000000000000000000000000000000000000000000000000000000000000000000000000000000000000000000000000000000000000000000000
00000000000066600600000000000000000000000000000000000000000000000000000000000000000000000000000000000000000000000710000000000000000000000000000000000000000000000000000000000000000000060000000000000000000000000000000000000000000000000000000000000000000000000000000000000000000000000000000000000000000000000000
00000000600066600600000000000000000000000000000000000000000000000000000000000000000000000000000000000000000000000710000000000000000000000000000000000000000000000000000000000000000000060000000000000000000000000000000000000000000000000000000000000000000000000000000000000000000000000000000000000000000000000000
00000000000066600600000000000000000000000000000000000000000000000000000000000000000000000000000000000000000000000710000000000000000000000000000000000000000000000000000000000000000300060000000000000000000000000000000000000000000000000000000000000000000000000000000000000000000000000000000000000000000000000000
00000000000066600600000000000000000000000000000000000000000000000000000000000000000000000000000000000000000000000710000000000000000000000000000000000000000000000000000000000000000363360000000000000000000000000000000000000000000000000000000000000000000000000000000000000000000000000000000000000000000000000000
00000000000066600600000000000000000000000000000000000000000000000000000000000000000000000000000000000000000000000710000000000000000000000000000000000000000000000000000000000000000163360000000000000000000000000000000000000000000000000000000000000000000000000000000000000000000000000000000000000000000000000000
00000000000066600600000000000000000000000000000000000000000000000000000000000000000000000000000000000000000000000710000000000000000000000000000000000000000000000000000000000003000063360000000000000000000000000000000000000000000000000000000000000000000000000000000000000000000000000000000000000000000000000000
00000000060066600600000000000000000000000000000000000000000000000000000000000000000000000000000000000000000000000710000000000000000000000000000000000000000000000000000000000001000063360000000000000000000000000000000000000000000000000000000000000000000000000000000000000000000000000000000000000000000000000000
00000000000066600600000000000000000000000000000000000000000000000000000000000000000000000000000000000000000000000710000000000000000000000000000000000000000000000000000000030000000070360000000000000000000000000000000000000000000000000000000000000000000000000000000000000000000000000000000000000000000000000000
00000000000066600600000000000000000000000000000000000000000000000000000000000000000000000000000000000000000000000710000000000000000000000000000000000000000000000000000000010000000070360000000000000000000000000000000000000000000000000000000000000000000000000000000000000000000000000000000000000000000000000000
00000000000066600600000000000000000000000000000000000000000000000000000000000000000000000000000000000000000000000710000000000000000000000000000000000000300000000000000300000000000063360000000000000000000000000000000000000000000000000000000000000000000000000000000000000000000000000000000000000000000000000000
10000000000066600600000000000000800000000000000000000000000100000000000000000000000000000000000000000000000000000711111111111111111100000000000003000300100000030000000100000000000063360000000000000000000000000000000000000000000000000000000000000000000000000000000000000000000000000000000000000000000000000000
10000000000066600600000000000000000000000000000000000000000000000000000000000000000000000000000000000000000000000777777777777777777700000000003301330100000330010300300000000000000063360000000000000000000000000000000000000000000000000000000000000000000000000000000000000000000000000000000000000000000000000000
10000000400066600600000000000000000000000000000000000000000000000000000000000000000000000000000000000000000000000000000000000000000000000003001100110000000110000100100000000000000063300000000000000000000000000000000000000000000000000000000000000000000000000000000000000000000000000000000000000000000000000000
10000000000066600600000000000000000001800000000000008100000000000000000000000000000000000000000000000000000000000000000000000000000000000301000000000000000000000000000000000000000063300000000000000000000000000000000000000000000000000000000000000000000000000000000000000000000000000000000000000000000000000000
10000000000000000600001000010000000011000000000000001100070000000000000000000000000000000000000000000000000000000000000000000000000000030100000000000000000000000000000000000000000063000000000000000000000000000000000000000000000000000000000000000000000000000000000000000000000000000000000000000000000000000000
10000000000000000600001000010000800011000000070000001100010000100001000010000700007000070000700007000000000000000000700700700700700700717777777777777777777777777777777777777777777763000000000000000000000000000000000000000000000000000000000000000000000000000000000000000000000000000000000000000000000000000000
11111111111111111111111111111111111111111111111111111111111111111111111111111111111111111111111111111111111111111111111111111111111111111111111111111111111111111111111111111111111111711111111111111111111111111111111111111111111111111111111111711111111111111111111111111111111111111111111111111111111111111111
11111111111111111111111111111111111111111111111111111111111111111111111111111111111111111111111111111111111111111111111111111111111111111111111111111111111111111111111111111111111111111111111111111111111111111111111111111111111111111111111111111111111111111111111111111111111111111111111111111111111111111111
