00000000000000000000000000000000000000000000000000000000000000000000000000000000000000000000000000000000000000000000000000000000000000000030000010000000000000000000000000000000000000000000000000000000000000000000000000000000000000000000000000000000000000000000000000000000000000000000000000000000000000000000
00000000000000000000000000000000000000000000000000000000000000000000000000000000000000000000000000000000000000000000000000000000000000000030000010000000000000000000000000000000000000000000000030000330000010000000000000000000000000000000000000000000000000000000000000000000000000000000000000000000000000000000
00000000000000000000000000000000000000000000000000000000000000000000000000000000000000000000000000000000000000000000000000000000000000000030000000000000003300000000000000000000000000000000000000000000000000000000000000000000000000000000000000000000000000000000000000000000000000000000000000000000000000000000
00000000000000000000000000000000000000000000000000000000000000000000000000000000000000000000000000000000000000000000000000000000000000000030000000000000000000000000000000000000000000000000000000000000000000000000000000000000001222222222222222222221000000000000000000000000000000000000000000000000000000000000
00000000000000000000000000000000000000000000000000000000000000000000000000000000000000000000000000000000000000000000000000000000000000000030010000000000000000000000000030000033000000000000010000000330000000000000000000000000011222222222222222222221100000000000000000000000000000000000000000000000000000000000
00000000000000000000000000000000000000000000000000000000000000000000000000000000000000000000000000000000000000000000000000000000000000000030010000000000000000000001111111000111100000000000010000111111000000000000000000000000111222222222222222222221110000000000000000000000000000000000000000000000000000000000
00000000000000000000000000000000000000000000000000000000000000000000000000000000000000000000000000000000000000000000000000000000000000000000000000000001100001100000000000000000000000000000000000000000000000000000000000000001111222222222222222222221111000000000000000000000000000000000000000000000000000000000
00000000000000000000000001100110000000000000000000000000000000000000000000000000000000000000000000000000000000000000000000000000000000000000000001000000000000003300000000000000000000000000000000000000000000000000000000000011111222222222222222222221111100000000000000000000000000000000000000000000000000000000
00000000000001100110011000000001100110001110001110010010010001000100010000000000000000000000000000000000000000000000000000000000330000000000000001000000000000000000000000000000000000000000000010000000000010000000000000000111111222222222222222222221111110000000000000000000000000000000000000000000000000000000
40000000000010000000000000000000000000000000000000000000000000000000000000000000000000000000000000000000000000000000000000011000000000110000000000000000000111000000000000010000000000000000000000000000000000000000000000001111111222222222222222222221111111000000000000000000000000000000000000000005000000000000
00000000000100000000000000000000000000000000000000000000000000000000000000000000000000000000000000000000000000000001100000011000330000110000000000000000000000000000000000000000000000000000000000000000000000000000000000011111111222222222222222222221111111100000000000000000000000000000000000000000000000000000
00000000001000000000000000000000000000000000000000000000000000000000000000000000000000000000000000000000000000000001130000011003003000110000000000000000000000000000000000000000000000000000000000000000000000000000000000111111111222222222222222222221111111110000000000000000000000000000000000000000000000000000
11111111111111111111111111111111111111111111111111111111111111111112211111111111111122211111111111111111111111111111111111111111111111111111111111221111111111111112221111111111111111111111111111111111111111111111111111111111111111112211111111111111111111111111111111111111111111111111111111111111111111111111
