0000000000000222222210000000000000000000000000000
1000000000000222222210000000000000000000000000000
1000000000000222222210000000000000000000000000000
1000000001110222222210000000000000000000000000000
1000000001310222222210122210000000000000000000000
1111111111111111111111111111111111111111111111111