0000000000000000000000000000000000000000000000000
0000000000000000000000000000000000000000000000000
0000000000000000000010000000000000000000000000000
0000000000000000010010000000000000000000000000000
0000000001110010010010000000000000000000000000000
0000000001310010010010122210000000000000000000000
1111111111111111111111111111111111111111111111111
