0000000000000000000000000000000000000000000000001
0000000000000000000000000000000000000000000000001
0000000000000000000000000000000000000000000000001
0000000000000000000000000000000000000000000000001
0000000000000000000000000000000000000000000000001
0000000000000000000000000000000000000000000000001
0000000000000000000000000000000000000000000000001
0000000000000000000000000000000000000000000000001
0000000000000000000000000000000000000000000000001
0000000000000000000000000000000000000000000000001
0000000000000000000000000000000000000000000000001
0000000000000000000000000000000000000000000000001
4000000000000000000000000000000000000000000000001
0000000000000000000000000000000000000000000000001
0000000000000000000000000000000000000000000000001
0000000000000000000000000000000000000000000000001
0000000000000000000010000000000000000000000000001
1000000000000000000010000000000000000000000000001
1000000000000000000010000000000000000000000000001
1000000001000000000010000000000000000000000000001
1000000001000000000010100010000000000000000000501
1111111111111111111111111111111111111111111111111