0000000000000000000010000000000000000000000000000
1000000000000000000010000000000000000000000000000
1000000000000000000010000000000000000000000000000
1000000001110010000010000000000000000000000000000
1000000001310010000010122210000000000000000000000
1111111111111111111111111111111111111111111111111